  *
    麻 	マ 	麻薬 麻酔 亜麻
    あさ 	麻

  *
    摩 	マ 	摩擦 摩天楼

  *
    磨 	マ 	研磨
    みがく 	磨く 磨き粉

  *
    魔 	マ 	魔法 悪魔 邪魔

  *
    毎
    每
    	マイ 	毎度 毎日 毎々

  *
    妹 	マイ 	姉妹 義妹 令妹
    いもうと 	妹

  *
    枚 	マイ 	枚数 枚挙 大枚

  *
    昧 	マイ 	曖昧 三昧

  *
    埋 	マイ 	埋没 埋蔵 埋葬
    うめる 	埋める 埋め立て 穴埋め
    うまる 	埋まる
    うもれる 	埋もれる 埋もれ木

  *
    幕 	マク 	幕切れ 天幕 暗幕
    バク 	幕府 幕末 幕僚

  *
    膜 	マク 	膜質 鼓膜 粘膜

  *
    枕 	まくら 	枕 枕元

  *
    又 	また 	又 又は

  *
    末 	マツ 	末代 本末 粉末
    バツ 	末子「（マッシ）とも」，末弟「（マッテイ）とも」
    すえ 	末 末っ子 末頼もしい

  *
    抹 	マツ 	抹殺 抹消 一抹

  *
    万
    萬
    	マン 	万一 万年筆 巨万
    バン 	万国 万端 万全

  *
    満
    滿
    	マン 	満月 満足 充満
    みちる 	満ちる 満ち潮
    みたす 	満たす

  *
    慢 	マン 	慢性 怠慢 自慢

  *
    漫 	マン 	漫画 漫歩 散漫

  *
    未 	ミ 	未来 未満 前代未聞

  *
    味 	ミ 	味覚 意味 興味
    あじ 	味 味見 塩味
    あじわう 	味わう 味わい
    三味線（しゃみせん）

  *
    魅 	ミ 	魅力 魅惑 魅する

  *
    岬 	みさき 	岬

  *
    密 	ミツ 	密約 厳密 秘密

  *
    蜜 	ミツ 	蜜 蜜月

  *
    脈 	ミャク 	脈絡 動脈 山脈

  *
    妙 	ミョウ 	妙案 奇妙 巧妙

  *
    民 	ミン 	民族 民主的 国民
    たみ 	民

  *
    眠 	ミン 	不眠 安眠 睡眠
    ねむる 	眠る 眠り
    ねむい 	眠い 眠たい 眠気

  *
    矛 	ム 	矛盾
    ほこ 	矛 矛先

  *
    務 	ム 	事務 職務 義務
    つとめる 	務める⇔「勤める 努める」，務め
    つとまる 	務まる⇔「勤まる」

  *
    無 	ム 	無名 無理 皆無
    ブ 	無事 無礼 無愛想
    ない 	無い⇔「亡い」 無くす 無くなる

  *
    夢 	ム 	夢幻 夢中 悪夢
    ゆめ 	夢 夢見る 初夢

  *
    霧 	ム 	霧笛 濃霧 噴霧器
    きり 	霧 霧雨 朝霧

  *
    娘 	むすめ 	娘 娘心 小娘

  *
    名 	メイ 	名誉 氏名 有名
    ミョウ 	名字 本名 大名
    な 	名 名前
    仮名（かな）
    名残（なごり）

  *
    命 	メイ 	命令 運命 生命
    ミョウ 	寿命
    いのち 	命 命拾い

  *
    明 	メイ 	明暗 説明 鮮明
    ミョウ 	明日「（あす）とも」 光明 灯明
    あかり 	明かり 薄明かり
    あかるい 	明るい 明るさ
    あかるむ 	明るむ
    あからむ 	明らむ
    あきらか 	明らかだ
    あける 	明ける⇔「開ける，空ける」，夜明け
    あく 	明く⇔「開く，空く」
    あくる 	明くる日 明くる朝
    あかす 	明かす 種明かし

  *
    迷 	メイ 	迷路 迷惑 低迷
    まよう 	迷う 迷い
    迷子（まいご）

  *
    冥 	メイ 	冥福
    ミョウ 	冥加 冥利

  *
    盟 	メイ 	加盟 同盟 連盟

  *
    銘 	メイ 	銘柄 碑銘

  *
    鳴 	メイ 	鳴動 悲鳴 雷鳴
    なく 	鳴く 鳴き声
    なる 	鳴る 耳鳴り
    ならす 	鳴らす

  *
    滅 	メツ 	滅亡 消滅 絶滅
    ほろびる 	滅びる
    ほろぼす 	滅ぼす

  *
    免
    免
    	メン 	免許 免除 放免
    まぬかれる 	免れる「（まぬがれる）とも」

  *
    面 	メン 	面会 顔面 方面
    おも 	川の面 面影 面長
    おもて 	面⇔「表」，細面
    つら 	面 面魂 鼻面
    真面目（まじめ）

  *
    綿 	メン 	綿布 綿密 純綿
    わた 	綿 真綿
    木綿（もめん）

  *
    麺
    麵
    	メン 	麺類

  *
    茂 	モ 	繁茂
    しげる 	茂る 茂み

  *
    模 	モ 	模範 模型 模倣
    ボ 	規模

  *
    毛 	モウ 	毛髪 毛細管 不毛
    け 	毛 毛糸 抜け毛

  *
    妄 	モウ 	妄信 妄想 迷妄
    ボウ 	妄言「（モウゲン）とも」

  *
    盲 	モウ 	盲点 盲従 文盲

  *
    耗 	モウ 	消耗
    コウ 	心神耗弱
    「モウ」は慣用音

  *
    猛 	モウ 	猛烈 猛獣 勇猛
    猛者（もさ）

  *
    網 	モウ 	網膜 漁網 通信網
    あみ 	網 網戸
    投網（とあみ）

  *
    目 	モク 	目的 目前 項目
    ボク 	面目「（メンモク）とも」
    め 	目 目立つ 結び目
    ま 	目の当たり 目深
    真面目（まじめ）

  *
    黙
    默
    	モク 	黙殺 暗黙 沈黙
    だまる 	黙る 黙り込む

  *
    門 	モン 	門戸 門下生 専門
    かど 	門 門口 門松

  *
    紋 	モン 	紋章 指紋 波紋

  *
    問 	モン 	問題 問答 訪問
    とう 	問う 問いただす
    とい 	問い
    とん 	問屋「（といや）とも」
