  *
    和 	ワ 	和解 和服 柔和
    オ 	和尚
    やわらぐ 	和らぐ
    やわらげる 	和らげる
    なごむ 	和む
    なごやか 	和やかだ
    日和（ひより）
    大和（やまと）

  *
    話 	ワ 	話題 会話 童話
    はなす 	話す 話し合い
    はなし 	話 昔話 立ち話

  *
    賄 	ワイ 	収賄 贈賄
    まかなう 	賄う 賄い

  *
    脇 	わき 	脇腹 両脇

  *
    惑 	ワク 	惑星 迷惑 誘惑
    まどう 	惑う 惑い

  *
    枠 	わく 	枠 枠内 窓枠

  *
    湾
    灣
    	ワン 	湾内 湾入 港湾

  *
    腕 	ワン 	腕章 腕力 敏腕
    うで 	腕 腕前 細腕
